##.##...####
##.#..####F#
..##.##.#..#
#..#...#..##
##S..#...#.#
##.##.###.##
